维护者：Hazel
版本号：1.0.2
更新时间：2025-08-15


词条

// Poppin'Party
Toyama Kasumi = 户山 香澄
Hanazono Tae = 花园 多惠
Ushigome Rimi = 牛込 里美
Yamabuki Saaya = 山吹 沙绫
Ichigaya Arisa = 市谷 有咲

// Roselia
Minato Yukina = 凑 友希那
Hikawa Sayo = 冰川 纱夜
Imai Lisa = 今井 莉莎
Udagawa Ako = 宇田川 亚子
Shirokane Rinko = 白金 燐子

// Afterglow
Mitake Ran = 美竹 兰
Aoba Moca = 青叶 摩卡
Uehara Himari = 上原 绯玛丽
Udagawa Tomoe = 宇田川 巴
Hazawa Tsugumi = 羽泽 鸫

// Pastel Palettes
Maruyama Aya = 丸山 彩
Hikawa Hina = 冰川 日菜
Shirasagi Chisato = 白鹭 千圣
Yamato Maya = 大和 麻弥
Wakamiya Eve = 若宫 伊芙

// Hello, Happy World!
Tsurumaki Kokoro = 弦卷 心
Seta Kaoru = 濑田 薰
Kitazawa Hagumi = 北泽 育美
Matsubara Kanon = 松原 花音
Okusawa Misaki = 奥泽 美咲
Michelle = 米歇尔

// Raise A Suilen
Wakana Rei = 和奏 瑞依
Asahi Rokka = 朝日 六花
Satou Masuki = 佐藤 增姬
Nyūbara Reona = 鳰原 玲於奈
Tamade Chiyu = 珠手 知优

// Morfonica
Kurata Mashiro = 仓田 真白
Kirigaya Touko = 桐谷 透子
Hiromachi Nanami = 广町 七深
Futaba Tsukushi = 二叶 筑紫
Yashio Rui = 八潮 瑠唯

// MyGO!!!!!
Takamatsu Tomori = 高松 灯
Chihaya Anon = 千早 爱音
Kaname Raana = 要 乐奈
Nagasaki Soyo = 长崎 素世
Shiina Taki = 椎名 立希
Rikki：立希

// Ave Mujica
Misumi Uika = 三角 初华
Misumi Hatsune = 三角 初音
Wakaba Mutsumi = 若叶 睦
Yahata Umiri = 八幡 海铃
Yuutenji Nyamu = 祐天寺 若麦
Togawa Sakiko = 丰川 祥子
Saki：祥子

// Mugendai Mewtype
Nakamachi Arale = 仲町 阿拉蕾
Miyanaga Nonoka = 宫永 野乃花
Minetsuki Ritsu = 峰月 律
Fuji Miyako = 藤 都子
Sengoku Yuno = 千石 由乃

// CHiSPA
Umino Natsuki = 海野 夏希
Taiko Satomi = 大湖 里实
Mori Fumika = 森 文华
Kawabata Mayu = 川端 真结

// Glitter Green
Ushigome Yuri = 牛込 百合
Nijikki Hinako = 二十骑 雏子
Uzawa Rii = 鹈泽 莉
Wanibe Nanana = 鳄部 七菜

// Sumimi
Sumita Mana = 纯田 真奈

Tsuzuki Shifune = 都筑 诗船
Toyama Asuka = 户山 明日香
Tsukishima Marina = 月岛 麻里奈

// 地点
Tsukinomori：月之森
Hanasakigawa：花咲川
Haneoka：羽丘
Girls' Academy：女子学园
Girls' School：女子学园


禁翻词条

// 乐队
Poppin'Party
Roselia
Afterglow
Pastel Palettes
Hello, Happy World
Raise A Suilen
Morfonica
MyGO
Ave Mujica
Mugendai Mewtype
CHiSPA
Glitter Green
Sumimi
